type octile
height 20
width 30
map
@@@@@@@@@@@@@@@@@@@@@@@@@@@@@@
@@@@@@@@@@@@@...@@@@@@@@@@@@@@
@@@@@@@@@@@.....@@@@@@@@@@@@@@
@@@@@.@@@@@....@@@@@.@@@@@@@@@
@@@@@..@@@@@:@@@@@@@..@@@@@@@@
@@@@@..@@@@@.@@@@@@@...@@@@@@@
@@@@@..@@@@@....@@@@...@@@@@@@
@@@@@@..@@@@@@@..@@@@@..@@@@@@
@@@@@@@..@@@@@@...@@@@..@@@@@@
@@@@@@@@..@@@@@...@@@@@..@@@@@
@@@@@@@@@.........@@@@@...@@@@
@@@....@@@@@@@@@..@@@@@....@@@
@.........@@@@@@...@@@@...@@@@
@...........@@@@....@@@@...@@@
@.........@@@@@....@@@@...@@@@
@@........@@@@@@.....@@@...@@@
@@@..@@@...@@@@@......@@..@@@@
@@@..@@@...........@.....@@@@@
@@@..@@@@.........@@@@@@@@@@@@
@@@@@@@@@@@@@@@@@@@@@@@@@@@@@@