type octile
height 6
width 6
map
......
.@@.@.
......
.@@.@.
.@@.@.
......