type octile
height 10
width 26
map
@@@@@@@@@@@@@@@@@@@@@@@@@@
@.@...........@..........@
@.@.........@.@......@@@@@
@.@.........@.@..........@
@.........@@@.@@@........@
@........................@
@......@@@@@@.@@@......@.@
@...........@.@........@.@
@...........@.@........@.@
@@@@@@@@@@@@@@@@@@@@@@@@@@
